#####################################################################
#                                                                   #
#       Author: NicolaMigliore                                      # 
#       Github: NicolaMigliore                                      #
#                                                                   #
# ---------------------------------------------------------------   #
#                         FUNCTION INFO                             #
# ---------------------------------------------------------------   #
#       Set player radiation effects for rad level 4.               #
#                                                                   #
#####################################################################

effect give @s minecraft:nausea 10
